#####################################
#                                   #
#  ### ### #   # ### ### ### #    # #
# #    # # #  #  # # # # # # ##   # #
#  #   # # # #   # # # # # # # #  # #
#   #  # # ###   # # ### # # #  # # #
#    # # # # ##  # # #o# ### #   ## #
# ###  ### #  ## ### ### # # #    # #
#                                   #
#####################################