    #####
    #.  #
    #H  #
  ###  ##
  #    #
  #o   #
  ######

