#####
#   #
#H  #
#  H####
#   #  ##
#o      #
#.##  .##
########
