  ####          
  #  ###########
  #    H   H H #
  # H# H #  H  #
  #  H H  #    #
### H# #  #### #
#o#H H H  ##   #
#    H #H#   # #
##  H    H H H #
 ####  #########
  ###  ###      
  #      #      
  #      #      
  #......#      
  #......#      
  #......#      
  ########
